11111111111111111111
1101C000000C00000011
11111111110C0KC11111
1P001110CE0000C00001
11011111100000011111
1000000000C001100001
1000110000000000C001
11111111111111111111
