11111111111111111111
1001C000000C00000011
11111111110C00C11111
1P00111EC00000C00001
11011111101111111111
1000000000C001100001
1000110000000000C001
11111111111111111111
